8 7 7 7 7 7 7
8 0 0 0 0 0 0
8 0 0 0 0 0 0
8 0 0 0 0 0 0
8 0 0 0 0 0 0
8 0 5 0 0 0 0
8 0 0 0 0 0 0