2 2 2 2 2 2 2
2 9 9 9 9 9 9
2 6 6 6 6 4 6
2 4 4 4 4 4 4
2 4 4 4 4 4 4
2 4 4 4 4 4 4
2 4 4 4 4 4 4